*****2****
* *   ****
*   **** *
* ****   *
*  *     2
*  ** *  *
*     * **
***  **  *
1     ****
**********